  #####
###   ###
# $  .  #
#@$  .# #
# $ #.  #
###   ###
  #####